Departamento	Localidades / Municipios destacados
Departamento Capital	Posadas (capital provincial) 


Departamento Apóstoles	Apóstoles 

Departamento Cainguás	Campo Grande 

Departamento Candelaria	Candelaria 

Departamento Concepción de la Sierra	Concepción de la Sierra 

Departamento Eldorado	Eldorado 

Departamento General Manuel Belgrano	Bernardo de Irigoyen 

Departamento Guaraní	San Vicente 

Departamento Iguazú	Puerto Esperanza, Puerto Iguazú, Puerto Wanda, Puerto Libertad 

Departamento Leandro N. Alem	Leandro N. Alem, Cerro Azul 

Departamento Libertador General San Martín	Puerto Rico, Capioví 

Departamento Montecarlo	Montecarlo, Caraguatay 

Departamento Oberá	Oberá 
Municipios & Comunas

Departamento San Ignacio	San Ignacio, Jardín América 
Misiones a Full

Departamento San Javier	San Javier 
Misiones a Full

Departamento San Pedro	San Pedro 
Población Urbana

Departamento Veinticinco de Mayo	Veinticinco de Mayo 
Wikipedia